#########################
#$#$# # # # # # # # # # #
#                       #
#     $                 #
#                       #
#                       #
#                       #
#                       #
#                       #
#                       #
#                       #
#     $                 #
#                       #
#                       #
#                       #
#     $                 #
#                       #
#                       #
#                       #
#########################
