#########################
#1  $ $                 #
# #$#$# # # # # # # # # #
#$$ $ $                 #
# # # # # # # # # # # # #
#                       #
# # # # # # # # # # # # #
#                       #
# # # # # # # # # # # # #
#                       #
# # # # # # # # # # # # #
#     $                 #
# # # # # # # # # # # # #
#                       #
# # # # # # # # # # # # #
#     $                 #
# # # # # # # # # # # # #
#                       #
#                      2#
#########################
